F 82,80,85
C 140,138,142

NO assets/texture/lab1.xpm
SO assets/texture/lab2.xpm
WE assets/texture/lab3.xpm
EA assets/texture/lab4.xpm


	 111111111111111	       11111
	 1000S0000001111          1100011
	 111000011111001         100000001 
	 1000000000000011111    100000000011
11111111111000001111100111111000000000001
10000000011000001110000000101000000000011111
1111D111111111011100000100D0D000000000000001
11110111111111011101000111111111111111111D11
110000001101010111000001                101 
100000000000000011000N01111             101
100000000000000011010000001             101  
110000011100010111110111111             101
1111D111111D1011111001                  101
1000000000000000000001                  101 
1000000111010000000001111111111111111111101
100000100000100000000D000000000000000000001
1111111100011111111111111111111111111111111
       11111 
