F 82,80,85
C 140,138,142

NO assets/texture/wall_iron1.xpm
SO assets/texture/wall_iron2.xpm
WE assets/texture/wall_iron3.xpm
EA assets/texture/wall_iron4.xpm

FLOOR assets/texture/small_iron_floor.xpm

                 111111 
                11000011
               11100M0111
              110000000011
              100000000001 
           111111111D11111111
   111  111111100000000001111111  111
  100111111000100000000001000111111001
  100111000000D00000M0000D000000111001
 110E0000000001100000000110000000000011
110000011111111100000000111111111000M001
11111111      110000000011      11111111
11            110000000011            11
               1000000001
               1000000001
               1110000111
            1111000000001111
          1110M0011111100M0111
          11111111    11111111