F 82,80,85
C 140,138,142

NO assets/texture/lab1.xpm
SO assets/texture/lab2.xpm
WE assets/texture/lab3.xpm
EA assets/texture/lab4.xpm

111111111111111111111111
1000000000D0D00000000001
100000000010100000000001
10000000001D100000000001
11D1111111101111111111D1
100D0000D00N0D0000000001
11D1111111101111111111D1
10000000001D100000000001
100000000010100000000001
1000000000D0D00000000001
111111111111111111111111
