F 64,64,64
C 128,128,128

NO assets/texture/stone3.xpm
SO assets/texture/stone4.xpm
WE assets/texture/metal_floor.xpm
EA assets/texture/metal_floor2.xpm

              111111111111111111111
              100000000000000000001
              100111111111110111101
              1001         10000001
111111111111111001         10011101
100000000000000001         1001 1011
1001111111111000011        1001 1011
1001         111001111111111001 1011
1001           100000000000000111011
1001           100111111111110110011
1001          11001        1101100011
100011111111111001         1000000011
100000000000000001         1001100011
100111111111100001111111111100110011
1001         1110000000000000111011
1001          1111111111111001 1011
1001                      1001 1011
10N11111111111111111111111100111011
1001                      100101011
11111111111111111111111111111111111
