F 255,5,20
C 90,0,0

NO assets/texture/fire1.xpm
SO assets/texture/fire2.xpm
WE assets/texture/fire3.xpm
EA assets/texture/fire4.xpm

111111111111111111
100000000000000001
101111110111111101
101000000000000101
101011111111110101
10N000000000000001
101011111111110101
101000000000000101
101111110111111101
100000000000000001
111111111111111111
