F 100,100,255
C 120,180,200

NO assets/texture/water3.xpm
SO assets/texture/water3.xpm
WE assets/texture/water3.xpm
EA assets/texture/water3.xpm

111111111111111
100000000000001
101111110111101
101000000000101
101011111111101
1010N0000000101
101011111111101
100000000000001
111111111111111
