F 82,80,85
C 140,138,142

NO assets/texture/old_iron1.xpm
SO assets/texture/old_iron2.xpm
WE assets/texture/old_iron3.xpm
EA assets/texture/old_iron4.xpm

FLOOR assets/texture/iron_floor.xpm



      111111111          1111111111                                     
     10000000001        100000000001                               
    100000M000001      10000000000001                             
   100000000000001    1000000000000001                            
  1000000000000000111100000000000000001                                    
 100000011110000001S0D000000011100000001                         
 100000000M10000001001000000010000000001                        
 100000000M10000001001000000011100000001                        
 100000011110000001001000000000000000001                                                                                          
 100000000000000001001000000000000000001                        
 100000000M00000001001000M00000000000M01                        
 100000000000000001001111111111111111111                                                                                          
  1000000000000000100000000000D000000001                    
   100000011000000111111000001100000001                     
    10000011000000000000000001 1000001                                                                                        
     1000000000000000000000001  10001                       
      100000000000010101000001   111                       
      111111100000011111000001                                                                                                   
      100000D0000001M101000001                            
      101111100000010000000001                             
      1M1   100000011000000001                                                                                               
      101    100000011000000001                           
      101     100000011000000001                         
      101      100000011000000001                                                                                            
      101       100000011000000001                         
      101        100000011100000001                        
1111111D111111111110000000111000000111111                                                                                         
10000000000000000000000000000000000000001                 
10000011000000110000001100000011000000001                 
1000001100M000110000001100000011000M00001                                                                                   
10000000000000000000000000000000000000001                 
11111111111111111111111111111111111111111                                                        
                                                                 














