F 82,80,85
C 140,138,142

NO assets/texture/meme1.xpm
SO assets/texture/meme2.xpm
WE assets/texture/meme3.xpm
EA assets/texture/meme4.xpm

SKYBOX assets/texture/memeskybox.xpm


              1111111111111111111111
          111110000000000000000000011
        110000000000000000000000000011
      11000000000000N00000000000000001 
      100000000000000000000000000000001
     1000000000000000000000000000000001 
     10000000000000000000111100000000001
    1100000111100000000110111110000000011
   110000011111110000010001111110000000011
   1000000000000110000111000000000011100001
  100001100000000000000000001100011000110001
  100000011110001000000000000011000010010001
  100000000000011000000100000000001110001001 
   10000100000110000000010000000110011101001 
   10001100000110000111010000111000010010001 
   1100111000000111000000011100100011000001  
    100110111000010000111100000111110000011  
    10010000111111111000010001110010000011   
    1001110000001000000001111101011000011    
    100111111101100110111110000011000001     
    100111111111111111110010000110000011     
    10011111111111101000001000110000001      
    1000110101001000000000011100000001       
    100011010000000001000111000000001        
    10000011111111111111100000000011         
    100000000000000000000000000011           
    1000000000000000000000000011             
    10000000000000000000000011               
    100000000000000000000011                 
    1100000000000000000111                   
     110000000000011111                      
       11111111111                           
                                             
                                             