F 45,42,46
C 25,23,27

NO assets/texture/stone3.xpm
SO assets/texture/stone4.xpm
WE assets/texture/metal_floor.xpm
EA assets/texture/metal_floor2.xpm

1111  111  1  111  111  111
1001  101  1111011110111101
1001111011110000000101001011
1000000000110000000000000001
1011000001110000001111000001111111111111111111
100100000000000000000000000D0000000000000001
111111111D1100000111000000111111011101101101
1000000000110000011101111100000011  1  1  1 
111101111111110111000000000000011
11110111110111011101010000000001
11000000110101D11100000010001111
10000000000000001100N00010001         1111
100000000000000011010100100011111111111001
1100000111010101111101111000D0000000000001
11110111 1110101 1011111100011111111111111
11111111 1111111 111111111111