F 255,55,255
C 255,255,138

NO assets/texture/north.xpm
SO assets/texture/south.xpm
WE assets/texture/west.xpm
EA assets/texture/east.xpm

111111111111
100M00M000001111
1000000000000001
10001000000M1111
100000001111
10000001
100N00M1
11111111
