F 255,55,255
C 255,255,138

NO texture/north.xpm
SO texture/south.xpm
WE texture/west.xpm
EA texture/east.xpm

  111111111111
1100000000001111
1010000000000001
1000010000001111
100000001111
10100001
10000001
11111111
