F 255,55,255
C 255,255,138

NO assets/texture/north.xpm
SO assets/texture/south.xpm
WE assets/texture/west.xpm
EA assets/texture/east.xpm

1111111111111111
100M00M000000001
1000000000000001
10001000000M0001
1000000000000001
1000000000000001
1000000000000001
1000000000000001
10000000000000M1
1000000000000001
1000000000000001
1000000000000001
1000000000000001
1000000000000001
100N000000000001
1111111111111111
