F 255,55,179
C 55,255,138

NO texture/north.xpm
SO texture/south.xpm
WE texture/west.xpm
EA texture/east.xpm

11111111
10000001
10100001
10000101
10000001
10100001
10000001
11111111
