F 255,55,255
C 255,255,138

NO assets/texture/north.xpm
SO assets/texture/south.xpm
WE assets/texture/west.xpm
EA assets/texture/east.xpm

111111111111
1000000000001111
1010000000000001
1000010000001111
100S00001111
10010001
10000001
11111111
