F 255,55,255
C 255,255,138

NO assets/texture/north.xpm
SO assets/texture/south.xpm
WE assets/texture/west.xpm
EA assets/texture/east.xpm

111111111111
1000000000001111
10000S0000000001
1000000000001111
100000001111
10000001
10000001
11111111
