F 255,105,180
C 255,105,180

NO assets/texture/rainbow_wall1.xpm
SO assets/texture/rainbow_wall2.xpm
WE assets/texture/rainbow_wall3.xpm
EA assets/texture/rainbow_wall4.xpm

SKYBOX assets/texture/rainbow_skybox.xpm
FLOOR assets/texture/rainbow_floor.xpm




                     11
                      111
                       1111
                        1111
                         11111
                           10011   1
                            10001111111
                             1100000011
                              1000011
                             110000011111
                           111111000001111
                        1111001110000001111
                       110000000000010N01111
                      11000000000001100001111
                      11110111111111000001111
                       11111111110000000000011
                        11   11000000000001111
                            110000000000000011
           11111          11100000000000001111
     1111111000111      111000000000000000001
   1110000000000111   11100000000000000001111
 1110001111111000111 11000000000000000000001
1000011 11   1100001110000000000000000011111
11111        110000000001000000001111011111       111
              110001001110000000111000111        100011
              110011011000000000001111111       111110011
               11011011000000000011011         100000111
                1111111000000000000011        11011100001
                1111100000000000000011        11011111101
          1111111100000000000000000001        1101001  11
        1111100000000011011000000000011        100011
       110000011111001111100000000000011       11001
      11001111111111111100000000000000111       11001
      11001           110000000000000000111      11001
      11011            1110000000000000001111      10011
       1001             11111000000000000001111     10001
       110111              111100110000000000011     1101
       110011                 1100010000000000011     1011
       11001                  111101000000000000111111101
       110011          1111111100111000000000000000000001
       111001         1110000000001100000000000011111111
        10011         100000000000000000000000011
        1111         1100000000000010000000000001
                     1110000000001111000000000001
                     1111000000011  1100000000011
                       1110000001    111100000011
                         111001111    1111100000111
                          110001111    1111110001111
                         11001111          111000111
                       1100011               110001
                   1111100011                110011
                 11100000111                  10011
                 110011111                    1001
                100011                        1101
                11111                         10011
                                            1110011
                                         111000011
                                        11000111
                                       1100011
                                        11111