F 139,99,58
C 171,154,137

NO textures/simonkraft/bookshelf.xpm
SO textures/simonkraft/bookshelf_01.xpm
WE textures/simonkraft/bookshelf_02.xpm
EA textures/simonkraft/bookshelf_03.xpm

1111111111111111111
1001001001001001001
1000000000000000001
1000000000000000001
1000000000000000001
100000000S000000001
1000000000000000001
1100000000000000011
1000000101010000001
1111111111111111111
