F 139,99,58
C 171,154,137

NO assets/texture/north.xpm
SO assets/texture/south.xpm
WE assets/texture/west.xpm
EA assets/texture/east.xpm


111111111
100SD0D01
111111111


111   1111111111111
1001  1001001001001
10001 1100000000001
10001  100000001111
10001  100000001   
1000111100000001   
1000000000000001111
1000000000000000011111111111111111
1000000001010000000000000000000001
1111111111111111111111110011111101
                       1001    101
                       1001    101
                       1001    101
                       10011111101
                       10000000001
                       11111111111
